--#---#------#---#---
#-----#---#------#---
---#------#---#------
----#--#-----#---#---
-#--------#----#-----
------#---#-----#----
--#------#-----#---#-
---#----#------#-----
#----#------#--------
----#----#---#-------
---#---#------#---#--
------#-----#---#----
-#---#---#----#------
----#------#------#--
#-----#---#------#---
---#---#------#------
-----#--#------#-----
#------#---#----#----
----#-----#---#------
------#---#------#---
