--#---#------#---#-----
#-----#---#------#-----
---#------#---#------#-
----#--#-----#---#-----
-#--------#----#-------
------#---#-----#---#--
--#------#-----#---#---
---#----#------#---#---
#----#------#---#------
----#----#---#---------
---#---#------#---#----
------#-----#---#------
-#---#---#----#--------
----#------#------#----
#-----#---#------#-----
---#---#------#--------
-----#--#------#---#---
#------#---#----#------
----#-----#---#--------
------#---#------#---#-
--#---#------#-----#---