--#---#----#--#----
#-----#---#--------
---#------#---#----
----#--#-----#-----
-#--------#----#---
------#---#-----#--
--#------#-----#---
---#----#------#---
#----#------#------
----#----#---#-----
---#---#------#----
------#-----#---#--
-#---#---#----#----
----#------#-------
#-----#---#------#-
---#---#------#----
-----#--#------#---