--#---#----
-----#-----
#---#---#--
---#------#
----#-----
--#----#---
-----#----#
-#---------
------#----
-----#-----