--#---#---
#-----#---
----#----#
---#---#--
-----#----
--#------#
----#---#-
-#--------
#-----#---
---#---#--
-#------#-
-----#---#
--#---#---
----#-----
-#---#----