--#---#-----
-----#---#--
#----#------
---#----#---
------#---#-
-#-------#--
--#---#-----
-----#---#--
#----#------
---#----#---
------#---#-
-#-------#--