--#------
----##---
---------
--#------
--------#
--#--#---
---------
-#---#---
-----#---
---#--#--
-----#---
---------
